das Kleid - Sukienka
die Bluse - Bluza
der Mantel - Płaszcz
die Jacke - Kurtka
der Schal - Szalik
die Mütze - Czapka
die Hose - Spodnie
der/das Sakko - Marynarka
das Hemd - Koszula
der Pulli - Sweter
das T-Shirt - T-Shirt
die Krawatte - Kwarat
der Rock - Spódnica
der Anzug - Garnitur
die Uhr - Zegarek
die Unterhose - Majtki
die Socken - Skarpetki
die Schuhe - Buty
die Sandalen - Sandały
die Stiefel - Kozaki (Buty)
gelb - żółty
grün - zielony
weiß - biały
schwarz - czarny
grau - szary
braun - brązowy
rot - czerwony
blau - niebielski
violett - fioletowy
pink - różowy (ostry)
rosa - różowy (łagodny)
anziehen - ubierać
tragen - nosić
Ich ziehe Hose, Bluse, Schuhe an - Ja ubieram Spodnie, Bluze, Buty